3 3 3 3 3 3 3 3 3 3 3 3 3 3 3 3 3 3 3 3 3 3 3 3 3 3 3 3 30 2 1 1 1 1 1 1 1 1 1 1 1 1 1 1 1 1 1 1 1 1 
3 3 3 3 3 3 3 0 0 0 0 0 3 3 3 3 3 3 3 3 3 3 3 3 3 3 3 3 30 2 1 21 21 21 21 21 21 21 21 21 21 21 21 21 21 21 21 21 21 1
3 3 3 3 3 3 3 3 0 0 0 0 3 3 3 3 3 3 3 3 3 3 3 3 3 3 3 3 30 2 1 21 21 21 29 21 21 21 21 21 21 21 21 21 21 21 21 21 21 1
3 0 0 0 0 0 0 0 0 3 3 3 3 1 1 1 1 1 1 3 3 3 3 3 3 3 3 3 30 2 1 21 21 21 21 21 21 21 21 21 21 21 21 21 21 21 21 21 21 1
3 0 0 0 0 0 0 0 3 3 3 3 3 1 6 36 6 6 1 3 3 3 3 3 3 3 3 3 30 2 1 21 21 21 21 21 21 21 21 21 21 21 21 21 21 21 21 21 21 1
3 0 0 0 0 0 0 0 3 3 3 3 3 1 6 6 6 6 1 3 3 3 3 3 3 3 3 3 30 2 1 21 21 21 21 21 21 21 21 21 21 21 21 21 21 21 21 21 23 1
3 0 0 0 0 0 0 0 3 3 3 3 3 1 36 6 6 37 1 3 3 3 3 3 3 3 3 3 30 2 1 1 1 1 1 1 1 1 21 1 1 1 1 1 1 1 1 1 1 1
3 0 0 0 0 0 0 0 3 3 3 3 3 1 6 6 6 6 1 3 3 3 3 3 3 3 3 3 30 2 27 27 27 27 27 27 28 1 21 1 26 27 27 27 27 27 27 27 27 27
3 0 0 0 0 0 0 0 3 3 3 3 3 1 1 1 6 1 1 3 3 3 3 3 3 3 3 3 30 2 2 2 2 2 2 2 32 1 21 1 30 2 2 2 2 2 2 2 2 2
3 0 0 0 0 0 0 0 3 3 3 3 3 3 3 3 0 3 3 3 3 3 3 3 3 3 3 3 30 2 2 2 2 2 2 2 32 1 21 1 30 2 2 2 2 2 2 2 2 2
3 3 3 3 4 3 3 3 3 3 3 3 3 3 3 3 0 3 3 3 3 3 3 3 3 3 3 3 30 2 2 2 2 2 2 2 32 1 21 1 30 2 2 2 2 2 2 2 2 2
3 3 3 3 4 3 3 3 3 3 3 3 3 3 3 0 0 0 0 0 0 3 3 3 3 3 3 3 31 33 33 33 33 33 33 33 34 1 21 1 31 33 33 33 33 33 33 33 33 33
3 3 3 3 4 4 4 4 4 4 4 4 4 4 4 0 0 0 0 0 0 3 3 3 3 3 3 3 3 3 3 3 1 1 1 1 1 1 4 1 1 1 1 1 1 1 3 3 3 3
3 3 3 3 4 3 3 3 3 3 3 3 3 3 3 0 0 0 0 0 0 3 3 3 3 3 3 3 3 3 3 3 1 4 4 4 4 4 4 4 4 4 4 4 4 1 3 3 3 3
3 3 3 3 4 3 3 3 3 3 3 3 3 3 3 0 0 0 0 0 0 3 3 3 3 3 3 3 3 3 3 3 1 4 4 4 4 4 4 4 4 4 4 4 4 1 3 3 3 3
3 3 3 3 4 3 3 3 3 3 3 3 3 3 3 0 0 0 0 0 0 3 3 3 3 3 3 3 3 3 3 3 1 4 4 4 4 4 4 4 4 4 4 4 4 1 3 3 3 3
3 3 3 3 4 3 3 3 3 3 3 3 3 3 3 3 3 3 3 3 3 3 3 3 3 3 3 3 3 3 3 3 1 4 4 4 4 4 4 4 4 4 4 4 4 1 3 3 3 3
3 3 3 3 4 3 3 3 3 3 3 3 3 3 3 3 3 3 3 3 3 3 3 3 3 3 3 3 3 3 3 3 1 4 4 4 4 4 4 4 4 4 4 4 4 1 3 3 3 3
3 3 3 3 4 3 3 3 3 0 0 0 0 0 3 3 3 3 3 3 3 3 3 3 3 3 3 3 3 3 3 3 1 4 4 4 4 4 4 4 4 4 4 4 4 1 3 3 3 3
3 3 3 3 4 3 3 3 3 0 0 0 0 0 3 3 3 3 3 3 1 1 1 1 1 1 1 3 3 3 3 3 1 1 1 1 1 1 4 1 1 1 1 1 1 1 3 3 3 3
3 3 3 3 4 3 3 3 3 0 0 0 0 0 3 3 3 3 3 3 1 6 6 6 6 6 1 3 3 3 3 3 3 3 3 3 3 11 4 10 3 3 22 22 3 3 3 3 3 3
3 3 3 3 4 4 4 4 4 0 0 0 0 0 3 3 3 3 3 3 1 6 6 6 6 6 1 3 3 3 3 3 3 3 3 3 3 11 4 10 6 6 6 6 3 3 3 3 3 3
3 3 3 3 4 3 3 3 3 0 0 0 0 0 3 3 3 3 3 3 1 6 6 6 6 6 1 3 3 3 3 3 3 3 3 3 3 11 4 4 6 6 6 6 22 3 3 3 3 3
3 3 3 3 4 3 3 3 3 0 0 0 0 0 3 3 3 3 3 3 1 6 6 6 6 6 1 3 3 3 3 3 3 3 3 3 3 11 4 10 6 6 6 6 6 3 3 3 3 3
3 3 3 3 4 3 3 3 3 3 3 3 3 3 3 3 3 3 3 3 1 1 1 6 1 1 1 3 3 3 3 3 3 3 3 3 3 11 4 10 3 3 3 3 3 3 3 3 3 3
3 3 3 3 4 3 3 3 3 3 3 3 3 3 3 3 3 3 3 3 3 3 1 6 1 3 3 3 3 3 3 3 3 3 3 3 3 11 4 10 3 3 3 3 3 3 3 3 3 3
3 3 3 3 4 3 3 3 3 3 3 3 3 3 3 3 3 3 3 3 3 3 1 6 1 3 3 3 3 3 3 3 3 3 3 3 3 11 4 10 3 3 3 3 3 3 3 3 3 3
3 3 3 3 4 3 3 3 3 26 27 27 28 3 3 3 3 3 3 3 3 3 1 6 1 3 3 3 3 3 3 3 3 3 3 3 3 11 4 10 3 3 3 3 3 3 3 3 3 3
3 3 3 3 4 3 3 3 3 31 33 33 34 3 3 3 3 3 3 3 3 3 1 6 1 3 3 3 3 3 3 3 3 3 3 3 3 11 4 10 3 3 3 3 3 3 3 3 3 3
3 3 3 3 4 3 3 3 3 3 3 3 3 3 3 3 3 3 3 3 3 3 1 6 1 3 3 3 3 3 3 3 3 3 3 3 3 11 4 10 3 3 3 3 3 3 3 3 3 3
3 3 3 3 4 3 3 22 3 3 3 22 3 3 3 3 3 3 3 3 3 3 1 6 1 3 3 3 3 3 3 3 3 3 3 3 0 11 4 10 3 3 3 3 3 3 3 3 3 3
3 3 6 6 6 6 3 6 3 3 3 6 3 3 3 3 3 3 3 3 3 3 1 6 1 3 3 3 0 3 3 3 3 3 3 3 3 11 4 10 3 3 3 3 3 3 3 3 3 3
3 3 6 6 6 6 3 6 3 3 3 6 3 3 3 3 3 3 3 3 3 3 1 6 1 3 3 3 0 3 3 3 3 3 3 3 3 11 4 10 3 3 3 3 3 3 3 3 3 3
3 6 6 6 6 6 3 6 3 3 3 6 0 13 13 13 13 13 13 13 13 13 14 4 12 13 13 13 13 13 13 13 13 13 13 13 13 14 4 10 3 3 3 3 3 3 3 3 3 3
3 6 6 6 6 6 6 6 6 6 6 6 6 4 4 4 4 4 4 4 4 4 4 4 4 4 4 4 4 4 4 4 4 4 4 4 4 4 4 10 3 3 3 3 3 3 3 3 3
3 6 6 6 6 6 3 3 3 3 3 6 3 20 20 20 20 20 20 20 20 20 20 20 20 20 20 20 20 20 20 20 20 20 20 20 20 9 4 10 3 3 3 3 3 3 3 3 3 3
3 3 6 6 6 6 3 3 3 3 3 6 3 3 3 3 3 3 3 3 3 3 3 3 3 3 3 3 3 3 3 3 3 3 3 3 3 11 4 10 3 3 3 3 3 3 3 3 3 3
3 3 6 6 6 6 3 3 3 3 3 6 3 3 3 3 3 3 3 3 3 3 3 3 3 3 3 3 3 3 3 3 3 3 3 3 3 11 4 10 3 3 3 3 3 3 3 3 3 3
3 3 3 3 3 3 3 3 3 3 3 6 3 22 3 3 3 3 3 3 3 3 3 3 3 3 3 3 3 3 3 3 3 3 3 3 3 11 4 10 3 3 3 3 3 3 3 3 3 3
3 3 3 3 3 3 3 3 3 3 3 6 6 6 3 3 3 3 3 3 3 3 3 3 3 3 3 3 3 3 3 3 3 3 3 3 3 11 4 10 3 3 3 3 3 3 3 3 3 3
3 3 3 3 3 3 3 3 3 3 3 3 3 3 3 3 3 3 3 3 3 3 3 3 3 3 3 3 3 3 3 3 3 3 3 3 3 11 4 10 3 3 3 3 3 3 3 3 3 3
3 3 3 3 3 3 3 3 3 3 3 3 3 3 3 3 3 3 3 3 3 3 3 3 3 3 3 3 3 3 3 3 3 3 3 3 3 11 4 10 3 3 3 3 3 3 3 3 3 3
3 3 3 3 3 3 3 3 3 3 3 3 3 3 3 3 3 3 3 3 3 3 3 3 3 3 3 3 3 3 3 3 3 3 3 3 3 3 4 3 3 3 3 3 3 3 3 3 3 3
3 5 5 5 5 5 5 5 5 5 5 5 5 5 5 5 5 5 5 35 5 5 5 5 5 5 5 5 5 5 5 5 5 5 5 5 5 5 5 5 5 5 5 5 5 5 5 5 5 3
3 5 5 5 5 5 5 5 5 5 5 5 5 5 5 5 5 5 5 5 5 5 5 5 5 35 5 5 5 5 5 5 5 5 5 5 5 5 5 5 5 5 5 5 5 5 5 5 5 3
3 5 5 5 5 5 5 5 5 5 5 5 5 5 5 5 5 5 5 5 5 5 35 5 5 5 5 5 5 35 5 5 5 5 35 5 5 5 5 5 5 5 5 5 5 5 5 5 5 3
3 5 5 5 5 5 5 5 5 5 5 5 5 5 5 5 5 5 5 5 5 5 5 5 5 5 5 5 5 5 5 5 5 5 5 5 5 5 5 5 5 5 5 5 5 5 5 5 5 3
2 2 2 2 2 2 2 2 2 2 2 2 2 2 2 2 2 2 2 2 2 2 2 2 2 2 2 2 2 2 2 2 2 2 2 2 2 2 2 2 2 2 2 2 2 2 2 2 2 2
2 2 2 2 2 2 2 2 2 2 2 2 2 2 2 2 2 2 2 2 2 2 2 2 2 2 2 2 2 2 2 2 2 2 2 2 2 2 2 2 2 2 2 2 2 2 2 2 2 2
2 2 2 2 2 2 2 2 2 2 2 2 2 2 2 2 2 2 2 2 2 2 2 2 2 2 2 2 2 2 2 2 2 2 2 2 2 2 2 2 2 2 2 2 2 2 2 2 2 2


